....X.............................................................................................................................
....X.............................................................................................................................
....X.............................................................................................................................
....X#............................................................................................................................
....XXXXXXXXXXXXXXXXXXXXXXXXXXXXXXXXXXXXXXXXXXXXXXX#..............................................................................
....XX............................................X...............................................................................
....XX..............#.............................X...............................................................................
....XX..............XXXXXXXXXXXXXXXXXXXXXXXXXXXXXXXXXXXXXXXXXXXXXXXXXXXXXXXXXXXXXXXXXXXXXXXXXXXXXXXXXXXXXXXXXXXXXXXXX#............
....XX..............X.............................X.................................................................X.............
....XX..............X.............................X.................................................................X.............
....XX..............X...............#.............X.................................................................X.............
....XX..............X....#..........XXXXXXXXXXXXXXXXXXXXXX#.........................................................X.............
....XX..............X....XXXXXXXXXXXXXXXXXXXXXXXXXXXXXXXXXXXXXXXXXXX#...............................................X.............
....XX..............X....X....#.....X.............X......X.........X................................................X.............
....XX..............X....X....XXXXXXXXXXXXXXXXXXXXXXXXXXXXXXXXX#...X................................................X.............
....XX........#.....X....X....X.....X.............X......X....X....X................................................X.............
....XX........XXXXXXXXXX#X..#.X.....X.............X......X....X....X................................................X.............
...#XXXXXXXXXXXXXXXXXXXX.X..XXXXXXXXXXXXXXXXXXXXXXXXXXXXXXXX#.X....X................................................X.............
.....X........X.....X..#.X..X.X.....X.............X......X.X.#X....X................................................X.............
.....X........X.....X..XXXXXXXXXXXXXXXXXXXX#......X......X.X.XXXXXXXXXXXXXXXXXXXXXXXXXXXXXXXXXXXXXX#................X.............
.....X.......#XXXXXXXXXXXXXXXXXXXXXXXXXXXXXXXXXXXXX......X.X.XX....X..............................X.................X.............
.....X.....#........X..X.X..X.X.....X.....X.......#......X.X.XX....X..............................X.................X.............
.....X.....XXXXXX#.#XXXXXXXXXXXXXXXXXXXXXXX..............X.X.XX....X..............................X.................X.............
.....X.....X....X......X.X..X.X.....X.....#..............X.X.XX#...X..............................X.................X.............
.....X.....X....X......X.X..X.X.....X....................X.X.XXXXXXXXXXXXXXXXXXXXXXXXXXXXXXXXXXXXXXXXXXXXXXXXXXXXXXXXXX#..........
.....X.....X....X......X.X..X.X.....X....................X.X.XXX...X..............................X.................X.X...........
.....X.....X....X......X.X..X.X.....X.....#..............X.X.XXX...X..............................X.................X.X...........
.....X.....X....X......X.X..X.X.....X.....XXXXXXXXXXXXXXXXXXXXXXXXXXXXXXXXXXXX#...................X.................X.X...........
.....X.....X....X......X.X..X.X.....X#....X..............X.X.XXX...X.........X....................X.................X.X...........
.....X.....X....X......X.X..X.X.....XXXXXXXXXXXXXXXXXXXXXXXXXXXXX#.X.........X....................X.................X.X...........
.....X.....X....X......X.X.#X.X.....XX....X..............X.X.XXXX..X.........X....................X.................X.X...........
.....X.....X....X......X.X.XXXXXXXXXXXXXXXXXXXXXXXXXXXXXXXXXXXXXXXXXXXXXXXXXXXXX#.................X.................X.X...........
.....X.....X....X......X.X.XX.X.....XX...#X..............X.X.XXXX..X.........X.X..................X.................X.X...........
.....X.....X....X......X.X.XX.X.....XX...XXXXXXXXXXXXXXXXXXXXXXXXXXXXXX#.....X.X..................X.................X.X...........
.....X.....X....X......X.X.XX.X.....XX...XX..............X.X.XXXX..X..X......X.X..................X.................X.X...........
.....X.....X....X......X.X.XX.X.....XX...XX..............X.X.XXXX..X.#X......X.X..................X.................X.X...........
.....X.....X....X......X.X.XX.X.....XX...XX..............X.X.XXXX..X.XXXXXXXXXXXXXXXXXXXXXXXXXXXXXXXXXXXXXXXXXXXXXXXXXXX#.........
.....X.....X....X......X.X.XX.X....#XXXXXXXXXXXXXXXXXXXXXXXXXXXXXXXX.XX......X.X..................X.................X.XX..........
.....X.....X....X......X.X.XX.X......X...XX.........#....X.X.XXXX..#.XX......X.X..................X.................X.XX..........
.....X.....X....X......X.X.XX.X......X...XX.........XXXXXXXXXXXXXXXXXXXXXXXXXXXXXXXXXXXX#.........X.................X.XX..........
.....X...#.X....X......X.X.XX.X......X...XX.........X....X.X.XXXX....XX......X.X.......X..........X.................X.XX..........
.....X...XXXXXXXXXXXXXXXXXXXXXXXXX#..X.#.XX.........X....X.X.XXXX....XX......X.X.......X..........X.................X.XX..........
.....X...X.X....X......X.X.XX.X..X...X.XXXXXXXXXXXXXXXXXXXXXXXXXXXXXXXXXXXXXXXXXXXXXXXXXXXXX#.....X.................X.XX..........
.....X...X.X....X......X.X.XX.X..X...X.X.XX.........X....X.X.XXXX....XX......X.X.......X...X......X.................X.XX..........
.....X...X.X....X......X.X.XX.X..X...X.X.XX.......#.X....X.X.XXXX....XX......X.X.......X...X......X.................X.XX..........
.....X...X.X....X......X.X.XX.X..X...X.X.XX.......XXXXXXXXXXXXXXXXXXXXXXXXXXXXXXXXXXXXXXXXXXXXXXXXXXXXXXXXXXXXXXXXXXXXXXXXXX#.....
.....X...X.X....X......X.X#XXXXXXXXXXXXXXXXXXXXXXXXXXXXXXXXXXXXXX....XX......X.X.......X...X......X.................X.XX...X......
.....X...X.X....X#.....X.X..X.X..X...X.X.X........X.X....X.X.X#XX....XX......X.X.......X#..X......X.................X.XX...X......
.....X...X.X....XXXXXXXXXXXXXXXXXXXXXXXXXXXXXXXXXXXXXXXXXXXXXXXXXXX#.XX......X.X.......XXXXXXXXXXXXXXXXXXX#.........X.XX...X......
.....X...X.X....XX.....X.X..X.X..X...X.X.X........X.X....X.X.X.XX.X..XX......X.X.......XX..X......X......X..........X.XX...X......
.....X...X.X....XX.....X.X..X.X..X...X.X#XXXXXXXXXXXXXXXXXXXXXXXXXXXXXXXXXXXXXXXXXXXXXXXXXXXXXXXXXXXXXXXXXXXXXXXXXXXX.XX...X......
.....X...X.X....XX.....X.X..X.X..X...X.X..........X.X.#..X.X.X.XX.X..XX......X.X.......XX..X......X......X..........#.XX...X......
.....X...X.X....XX.....X.X..X.X..X...X.X..........X.X.XXXXXXXXXXXXXXXXXXXXXXXXXXXXXXXXXXXXXXXXXXX#X......X............XX...X......
.....X...X#XXXXXXXXXXXXXXXXXXXXXXX...X.X..........X.X.X..X.X.X.XX.X..XX......X.X.......XX..X....X.X......X............XX...X......
.....X...X......XX.....X.X..X.X..#...X.X..........X.X.X..X.X.X.XX.X..XX......X.X.......XX..X....X.X......X............XX...X......
.....X...X......XX.....X.X..X.X......X.X..........X.X.X..X.X.X.XX.X..XX....#.X.X.......XX..X....X.X......X............XX...X......
.....X...X......XX.....X.X..X.X......X.X..........X.X.X..X.X.X.XX.X..XX....XXXXXXXXXXXXXXXXXXXXXXXXXXXXXXXXXXXXXXX#...XX...X......
.....X...X......XX.....X.X..X.X..#...X.X..........X.X.X..X.X.X.XX.X..XX....X.X.X.......XX..X....X.X......X.......X....XX...X......
.....X...X......XX.....X.X..X.X..XXXXXXXXXXXXXXXXXXXXXXXXXXXXXXXXXXXXXXXXXXXXXXXXXXXXXXXXXXXXXXXXXXXXXXXXXXXXXXX#X....XX...X......
....#XXXXXXXXXXXXX.....X.X..X.X..X...X.X..........X.X.X..X.X.X.XX.X..XX....X.X.X.......XX..X....X.X......X.....X.X....XX...X......
.........X......#X.....X#XXXXXXXXXXXXXXXXXXXXXXXXXXXXXXXXXXXXXXXXXXXXXXXXXXXXXXXXXXXXXXXXXXXXXXXXXXXXXXXXXXXXXXXXXXXXXXXXXXX......
.........X.......X.....X....X.X..X.#.X.X..........X.X.X..X.X.X.XX.X..XX....X.X.X.......XX..X....X.X......X.....X.X....XX...#......
.........X.......X.....X....X.X..X.XXXXXXXXXXXXXXXXXXXXXXXXXXXXXXXXXXXXXXXXXXXXXXXXXXXXXXXXXXXXXXXXXXXXX#X.....X.X....XX..........
.........X.......X.....X....X.X..X.X.X.X.........#XXXXXXXXXXXXXXXXXXXXXXXXXXXXXXXXXXXXXXX..X....X.X....X.X.....X.X....XX..........
.........X.......X.....X....X.X..X.X.X.X............X.X..X.X.X.XX.X..XX....X.X.X.......#X..X....X.X....X.X.....X.X....XX..........
.........X.......X.....X....X.X..X.X.X.X............X.X..X.X.X.XX.X..XX....X.X.X........X..X....X.X....X.X.....X.X....XX..........
.........X.......X....#XXXXXXXXXXXXXXXXXXXXXXXXXXXXXXXXXXXXXXXXXXXXXXXXXXXXXXX.X........X..X....X.X....X.X.....X.X....XX..........
.........X.......X..........X.X..X.X.X.X............X.X..X.X.X.XX.X..XX....X.#.X........X..X....X.X....X.X.....X.X....XX..........
.........X.......X....#.....X.X..X.X.X.X............X.X..X.X.X.XX.X..XX....X...X........X..X....X.X....X.X.....X.X....XX..........
.........X.......X....XXXXXXXXXXXXXXXXXXXXXXXXXXXXXXXXXXXXXXXXXXXXXXXXXXXXXXXXXXXXXXXXX#X..X....X.X....X.X.....X.X....XX..........
.........X.......X....X.....X.X..X.X.X.X............X.X..X.X.X#XXXXXXXXXXXXXXXXXXXXXXXXXXXXXXXXXXXXXXXXXXX.....X.X....XX..........
.........X.......X....X.....X.X..X.X.X.X...........#XXXXXXXXXXXXXXXXXXXXXXXXXXXX......X.X..X....X.X....X.#.....X.X....XX..........
.........X.......X....X.....X.X..X.X.X.X..............X..X.X.X..X.X..XX....X...#......X.X..X....X.X....X.......X.X....XX..........
.........X.......X....X.....X.X..X.X.X.X..............X..X.X#XXXXXXXXXXXXXXXXXXXXXXXXXXXXXXXXXXXXXXXXXXXXXXXXXXXXXXXXXXX..........
.........X.......X....X.....X.X..X.X.X.X..............X..X.X....X.X..XX....X..........X.X..X....X.X....X.......X.X....#X..........
........#XXXXXXXXXXXXXXXXXXXXXXXXXXXXXXXXXXXXXXXXXXXXXXXXX.X....X.X..XX....X..........X.X..X....X.X....X.......X.X.....X..........
.................X....X.....X.X..X.X.X.X..............X..#.X....X.X..XX....X..........X.X..X....X.X....X.......X.X.....X..........
.................X....X.....X.X..X.X.X.X..............X....X....X.X..XX....X..........X.X..X....X.X....X.......X.X.....X..........
.................X....X.....X.X..X.X#XXXXXXXXXXXXXXXXXXXXXXXXXXXXXXXXXX....X..........X.X..X....X.X....X.......X.X.....X..........
.................X...#XXXXXXXXXXXXXXXXXXXXXXXXXXXXXXXXXXXXXXXXXXXXX..X#..#.X..........X.X..X....X.X....X.......X.X.....X..........
.................X..........X.X..X.X...X..............X....X....X.#..X...XXXXXXXXXXXXXXXXXXXXXXXXXXXXXXXXXXX#..X.X.....X..........
.................X..........X.X..X.X...X...........#..X....X....X....X...X.X..........X.X..X....X.X....X...X...X.X.....X..........
.................X..........X.X..X.X...X...........XXXXXXXXXXXXXXXXXXXXX#X.X..........X.X..X....X.X....X...X...X.X.....X..........
.................X..........X.X..X.X...X...........X..X....X....X....X.X.X.X..........X.X..X....X.X....X...X...X.X.....X..........
.................X..........X#XXXXXXXXXXXXXXXXXXXXXXXXXXXXXXXXXXXXXXXXXX.X.X..........X.X..X....X.X....X...X...X.X.....X..........
.................X..........X....X.X...X...........X..X....X....X....X.#.X.X..........X.X..X....X.X....X...X...X.X.....X..........
.................X..........X....X.X..#XXXXXXXXXXXXXXXXXXXXXXXXXXXXXXXXXXXXXXXXXXXXXXXXXXXXXXXXXX.X....X...X...X.X.....X..........
.................X..........X....X.X...............X..X....X....X....X...X.X..........X.X..X....#.X....X...X...X.X.....X..........
.................X..........X....X.X...............X..X....X....X....X...X.X..........X.X..X......X....X#..X...X.X.....X..........
.................X..........X....X.X...............X..X....X....X....X...X.X..........X.X..X......X....XXXXXXXXXXXXX#..X..........
................#XXXXXXXXXXXXXXXXXXXXXXXXXXXXXXXXXXXXXXXXXXXXXXXX....X...X.X..........X.X..X......X....XX..X...X.X.X...X..........
................XXXXXXXXXXXXXXXXXXXXXXXXXXXXX#.....X..X....X....#....X...X.X..........X.X..X......X....XX..X...X.X.X...X..........
...............#XXXXXXXXXXXXXXXXXXXXXXXXXXXXXXXXXXXXXXXXXXXXXXXXXXXXXXXXXXXXXXXXXXXXXXXXXXXXXXXXXXXXXXXXXXXXXXXX.X.X...X..........
............................X....X#XXXXXXXXXXXXXXXXXXXXXXXXX.........X...X.X..........X.X..X......X....XX..X...#.X.X...X..........
............................X....X..........X......X..X....#.........X...X.X..........X.X..X......X....XX..X.....X.X...X..........
............................X....X..........X......X..X..............X.#.X.X..........X.X..X......X....XX..X.....X.X...X..........
............................X....X..........X......X..X..............X.XXXXXXXXXXXXXXXXXXXXXXXXXXXXXX#.XX..X.....X.X...X..........
............................X....X..........X......X.#XXXXXXXXXXXXXXXXXXXXXXXXXXXXXXXXXXXXXXXXXXXXXXXXXXX..X.....X.X...X..........
............................X....X..........X......X.#...............X.X.X.X..........X.X..X......X.X..#XXXX.....X.X...X..........
............................X....X..........X......X.XXXXXXXXXXXXXXXXXXXXXXXXX#.......X.X..X......X.X......#.....X.X...X..........
............................X....X..........X......X.X...............X.X.X.X.X........X.X..X......X.X............X.X...X..........
............................X....X..........X......X#XXXXXXXXXXXXXXXXXXXXXXXXXXXXXXXXXXXXXXXXXXXXXXXXXXXXXXXXXXXXX.X...X..........
............................X....X..........X......X.................X.X.X.X.X........X.X..X......X.X............#.X...X..........
............................X....X..........X......X.................X#XXXXXXXXXXXXXXXXXXXXXXXXXXXXXXXXXXXXXXXXXXXXXXXXX..........
............................X....X..........X......X.................X...X.X.X........X.X..X......X.X..............X...#..........
............................X....X..........X......X.................X...X.X.X........X.X..X......X.X..............X..............
............................X....X..........X......X................#XXXXXXXXXXXXXXXXXXXXXXXXXXXXXX.X..............X..............
............................X....X..........X......X.....................X.X.X........X.X..X......#.X..............X..............
............................X....X..........X......X.....................X#XXXXXXXXXXXXXXXXXXXXXXXXXXXXXXXXXXXXXXXXX..............
............................X....X..........X......X.....................X...X........X.X..X........X..............#..............
............................X...#XXXXXXXXXXXXXXXXXXXXXXXXXXXXXXXXXXXXXXXXXXXXXXXXXXXXXX.X..X........X.............................
............................X...............X......X.....................X...X........##XXXX........X.............................
............................X...............X......X.....................X...X.............#........X.............................
............................X...............X......X.....................X...X......................X.............................
............................X...............X......X.....................X...X......................X.............................
............................X...............X......X.....................X...X......................X.............................
............................X...............X......X....................#XXXXXXXXXXXXXXXXXXXXXXXXXXXX.............................
............................X...............X......X.........................X......................#.............................
............................X...............X......X.........................X....................................................
............................X...............X......X.........................X....................................................
............................X...............X......X.........................X....................................................
............................X...............X......X.........................X....................................................
............................X...............X......X.........................X....................................................
...........................#XXXXXXXXXXXXXXXXX......X.........................X....................................................
............................................#.....#XXXXXXXXXXXXXXXXXXXXXXXXXXX....................................................
.............................................................................#....................................................
..................................................................................................................................
..................................................................................................................................
..................................................................................................................................
..................................................................................................................................